,Phase 1_Labeled,Phase 2_Labeled,Total_Labeled,Phase 1_Unlabeled,Phase 2_Unlabeled,Total_Unlabeled
Human,1827,328,2155,0,0,0
PGPT1,1506,1068,2574,0,0,0
PGPT2,1212,1080,2292,0,0,0
VGPT1,661,491,1152,0,0,0
VGPT2,652,408,1060,0,0,0
POS1,413,48,461,658,0,658
POS2,0,0,0,0,0,0
VOS1,0,0,0,0,0,0
VOS2,0,0,0,0,0,0
VOGPT1,0,106,106,0,0,0
VOGPT2,0,73,73,0,4,4
